Black Island
An Interactive Fiction by Jens Thiede
Release 1 / Serial number 100621 / Inform 7 build 5Z71 (I6/v6.31 lib 6/12N) SD

The Restless Night
Welcome to my first, (as yet) unfinished interactive fiction game. In future versions this text will be replaced with an introduction to the story. For now, all you can do is walk through the itemless world - have fun. =P

Northeast Beach
Thankfully you managed to land here, on the beach, when you ran out of fuel. If you look to the southeast, it is obvious that your trusty airplane wasn't as lucky. To the southwest the beach barely has any wreckage.

>sw
Northeast Beach (Inshore)
There's a marsh to the southwest. The remains of your aircraft are to the west. The beach continues to the northwest, northeast and southeast.

>s
Marsh
You are at a marsh, it has some reeds and a few bugs. To the northeast, there's a Beach near the crash site. The forest continues to the northwest and southeast.

>sw
Small Pond
You are at a pond, it has some reeds and a few bugs. To the southwest, there's a clearing near the crash site. The forest continues to the northwest and southeast.

>se
Northeast Woods
You can hear birds in the trees around you, while the sun is squinting at you through the copper leaves. The forest continues to the south and the northwest. To the west you can see a cave entrance and to the east there's a clearing on the beach near the crash site.

>w
Cave Entrance
You are at the enterance of the cave, suprisingly, it's not too dark in there. The cave continues to the west, and the forest starts to the east.

>w
Cave Corridor
The mountain has erroded to the point where the cave has a crack in the ceiling here and there, which alows light to flow through and into the cave illuminating it just right. There are passages to the south, southwest and north.

>s
South Chamber
The floor slopes down into a large pool of rainwater which fills most of the chamber. The corridor is back to the north.

>n
Cave Corridor
The mountain has erroded to the point where the cave has a crack in the ceiling here and there, which alows light to flow through and into the cave illuminating it just right. There are passages to the south, southwest and north.

>n
North Chamber
There's a single crack in the ceiling, the chamber is dry, there's even place for a fire. This looks like a good place to sleep.

>s
Cave Corridor
The mountain has erroded to the point where the cave has a crack in the ceiling here and there, which alows light to flow through and into the cave illuminating it just right. There are passages to the south, southwest and north.

>sw
Southwest Chamber
This room is dark, there isn't really much you can see. Looks like a good place to store things. The corridor is back to the northeast.

>s
You can't go that way.

>l
Southwest Chamber
This room is dark, there isn't really much you can see. Looks like a good place to store things. The corridor is back to the northeast.

* * *

>s
Marsh
You are at a marsh, it has some reeds and a few bugs. To the northeast, there's a Beach near the crash site. The forest continues to the northwest and southeast.

>ne
You can't go that way.

>n
Northeast Beach (inshore)
There's a marsh to the south. The beach continues to the west, northeast and southeast.

* * *

>sw
Northeast Beach (Inshore)
There's a marsh to the southwest. The remains of your aircraft are to the west. The beach continues to the northwest, northeast and southeast.

>sw
Marsh
You are at a marsh, it has some reeds and a few bugs. To the northeast, there's a Beach near the crash site. The forest continues to the northwest and southeast.

>ne
Northeast Beach (inshore)
There's a marsh to the southwest. The remains of your aircraft are to the west. The beach continues to the northwest, northeast and southeast.

>se
East Beach (inshore)
You are standing in a Beach on the beach, between the airplane wreckage to the northeast, and the forest to the west. The beach continues to the south and northwest.

>nw
Northeast Beach (inshore)
There's a marsh to the southwest. The remains of your aircraft are to the west. The beach continues to the northwest, northeast and southeast.

>sw
Marsh
You are at a marsh, it has some reeds and a few bugs. To the northeast, there's a Beach near the crash site. The forest continues to the northwest and southeast.

>nw
North Woods
You can see the mountain in the south. There's a marsh to the southeast, and the edge of the forest is to the west.

>se
Marsh
You are at a marsh, it has some reeds and a few bugs. To the northeast, there's a Beach near the crash site. The forest continues to the northwest and southeast.

>ne
Northeast Beach (inshore)
There's a marsh to the southwest. The remains of your aircraft are to the west. The beach continues to the northwest, northeast and southeast.

>ne
Northeast Beach
Thankfully you managed to land here, on the beach, when you ran out of fuel. If you look to the southeast, it is obvious that your trusty airplane wasn't as lucky. To the southwest the beach barely has any wreckage.

>sw
Northeast Beach (inshore)
There's a marsh to the southwest. The remains of your aircraft are to the west. The beach continues to the northwest, northeast and southeast.

>sw
Marsh
You are at a marsh, it has some reeds and a few bugs. To the northeast, there's a Beach near the crash site. The forest continues to the northwest and southeast.

>sw
You can't go that way.

>sw
You can't go that way.

I beg your pardon?

>dgff
That's not a verb I recognise.

>i
You are carrying nothing.

>l
Marsh
You are at a marsh, it has some reeds and a few bugs. To the northeast, there's a Beach near the crash site. The forest continues to the northwest and southeast.

* * *

>sw
Northeast Beach (Inshore)
There's a marsh to the southwest. The remains of your aircraft are to the west. The beach continues to the northwest, northeast and southeast.

>se
East Beach (Inshore)
You are standing in a Beach on the beach, between the airplane wreckage to the northeast, and the forest to the west. The beach continues to the south and northwest.

>s
East Beach
You are standing on the beach in a small bay, the vast ocean extends beyond the horizon to the east. North of you is a Beach between the forest and the airplane wreck. To the west, the forest starts. The beach continues to the south.

>n
East Beach (Inshore)
You are standing in a Beach on the beach, between the airplane wreckage to the northeast, and the forest to the west. The beach continues to the south and northwest.

>w
Northeast Woods
You can hear birds in the trees around you, while the sun is squinting at you through the copper leaves. The forest continues to the south and the northwest. To the west you can see a cave entrance and to the east there's a Beach on the beach near the crash site.

* * *

>s
East Beach
You are standing on the beach in a small bay, the vast ocean extends beyond the horizon to the east. North of you is a Beach between the forest and the airplane wreck. To the west, the forest starts. The beach continues to the south.

>w
East Woods
You are standing in the autum leaves that the trees around you shed. Off to the west you can see, through the trees, a steep mountain. The forrest continues to the north and south. The beach is east of you.

>w
You can't go that way.

>e
East Beach
You are standing on the beach in a small bay, the vast ocean extends beyond the horizon to the east. North of you is a Beach between the forest and the airplane wreck. To the west, the forest starts. The beach continues to the south.

>n
East Beach (Inshore)
You are standing in a Beach on the beach, between the airplane wreckage to the northeast, and the forest to the west. The beach continues to the south and northwest.

>w
Northeast Woods
You can hear birds in the trees around you, while the sun is squinting at you through the copper leaves. The forest continues to the south and the northwest. To the west you can see a cave entrance and the beach is to the east.

* * *

>se
East Beach (Inshore)
You are standing in a Beach on the beach, between the airplane wreckage to the northeast, and the forest to the west. The beach continues to the south and northwest.

>ne
West Crash Site
You are standing to the west of of the smouldering wreck. To the east there's more wreckage. There are clearings to the southwest and the northwest.

>e
East Crash Site
You are standing to the east of the dismal wreck. Other than the west side of the wreck, from which you just came, there isn't anywhere to go but into the vast ocean.

>w
West Crash Site
You are standing to the west of of the smouldering wreck. To the east there's more wreckage. There are clearings to the southwest and the northwest.

>sw
Clearing Southwest of Crash Site
You are standing in a clearing on the beach, between the airplane wreckage to the northeast, and the forest to the west. The beach continues to the south and northwest.

>s
East Beach
You are standing on the beach in a small bay, the vast ocean extends beyond the horizon to the east. North of you is a clearing between the forest and the airplane wreck. To the west, the forest starts. The beach continues to the south.

>se
Southeast Peninsula
You are on a small peninsula, there's a lot of sand here, other than that, there's more beach to the northwest, and a small cove to the west.

>w
South Cove
You are standing in a small cove with a few small rocks around you, and a few sharp-looking boulders in the ocean. Two sea birds stare at you with puzzled expressions. The never-ending ocean is to the south. Both to the east and west, there's beach, and to the northwest, the forest.

>w
South Beach
There are a few more rocks here, and a seabird eating an oyster. The beach continues to the west, and the forest is to the north.

>w
Southwest Beach
There are large boulders here. To the north is an open space ideal for building something. To the east there's more beach.

>n
Upper Southwest Beach
This part of the island is sheltered from wind by the boulders around you. To the northwest, there's a cove, "ideal to launch a raft from!", you think. To the east is the forest. To the south is a rocky beach and to the north there is sandy beach.

>nw
Southwest Cove
There aren't any rocks here, not on land nor in the sea itself. To the southwest there's a windstill area of the beach from which you just came.

>se
Upper Southwest Beach
This part of the island is sheltered from wind by the boulders around you. To the northwest, there's a cove, "ideal to launch a raft from!", you think. To the east is the forest. To the south is a rocky beach and to the north there is sandy beach.

>n
West Beach
There isn't much beach here, mostly ocean. To the east is the forest, the beach continues in a northanly dirrection and to the south, where there are some large boulders.

>n
Northwest Beach
The beach protudes a little into the sea here. To the east is the forest, and the beach continues to the northeast and to the south.

>ne
North Beach
You're on the beach, near to the crash site. To the north there's a small peninsula. There's beach to the southwest and southeast; and to the south is the forest.

>n
North Peninsula
You're standing on a small peninsula with the sea all around you, except to the south where the peninsula joins the rest of the island.

>s
North Beach
You're on the beach, near to the crash site. To the north there's a small peninsula. There's beach to the southwest and southeast; and to the south is the forest.

>se
Clearing West of Crash Site
You are standing on the beach, there's a gentle, cool breeze blowing and the waves of the ocean are calming, yet also, eerily disconcerting, reminding you that you are alone. To the east is a large rock around which are two routes to the airplane wreckage -- northeast and southeast. The beach extends to the northwest. To the southwest there's a small pond.

>sw
Small Pond
You are at a pond, it has some reeds and a few bugs. To the southwest, there's a clearing near the crash site. The forest continues to the northwest and southeast.

* * *

>sw
Northeast Beach (Inshore)
There's a marsh to the southwest. The remains of your aircraft are to the west. The beach continues to the northwest, northeast and southeast.

>w
North Beach
You're on the beach, near to the crash site. To the north there's a small peninsula. There's beach to the southwest and southeast; and to the south is the forest.

>e
Northeast Beach (inshore)
There's a marsh to the southwest. The beach continues to the west, northeast and southeast.

* * *

>sw
Northeast Beach (Inshore)
There's a marsh to the southwest. The remains of your aircraft are to the west. The beach continues to the northwest, northeast and southeast.

>ne
Northeast Beach
Thankfully you managed to land here, on the beach, when you ran out of fuel. If you look to the southeast, it is obvious that your trusty airplane wasn't as lucky. To the southwest the beach barely has any wreckage.

>sw
Northeast Beach (inshore)
To the south is a small forest. The beach continues to the west, northeast and southeast.

>nw
You can't go that way.

>w
North Beach
You're on the beach, near to the crash site. To the north there's a small peninsula. There's beach to the southwest and southeast; and to the south is the forest.

>e
Northeast Beach (inshore)
To the south is a small forest. The beach continues to the west, northeast and southeast.

>sw
You can't go that way.

>s
Small Pond
You are at a pond, it has some reeds and a few bugs. To the northeast, there's a Beach near the crash site. The forest continues to the northwest and southeast.

>n
Northeast Beach (inshore)
To the south is a small forest. The beach continues to the west, northeast and southeast.

>se
East Beach (inshore)
You are standing in a Beach on the beach, between the airplane wreckage to the northeast, and the forest to the west. The beach continues to the south and northwest.

>nw
Northeast Beach (inshore)
To the south is a small forest. The beach continues to the west, northeast and southeast.

* * *

>ne
Northeast Beach
Thankfully you managed to land here, on the beach, when you ran out of fuel. If you look to the southeast, it is obvious that your trusty airplane wasn't as lucky. To the southwest the beach barely has any wreckage.

>se
West Crash Site
You are standing on the west side of the airplane, it saddens you to see the wreckage, it feels as though you lost a good friend. There is more of the airplane to the east; but not much on the beach to the northwest and southwest.

>nw
Northeast Beach
Thankfully you managed to land here, on the beach, when you ran out of fuel. If you look to the southeast, it is obvious that your trusty airplane wasn't as lucky. To the southwest the beach barely has any wreckage.

>sw
North Beach_Inshore
Hello

* * *

>se
West Crash Site
You are standing on the west side of the airplane, it saddens you to see the wreckage, it feels as though you lost a good friend. There is more of the airplane to the east; but not much on the beach to the northwest and southwest.

>e
East Crash Site
You are standing on the east side of your airplane. It doesn't look any better from this angle; might as well go back to the west side.

* * *

>se
Wreckage (West)
You are standing on the west side of the airplane, it saddens you to see the wreckage, it feels as though you lost a good friend. There is more of the airplane to the east; but not much on the beach to the northwest and southwest.

>sw
Clearing Southwest of Crash Site
You are standing in a clearing on the beach, between the airplane wreckage to the northeast, and the forest to the west. The beach continues to the south and northwest.

>ne
West Crash Site
You are standing to the west of of the smouldering wreck. To the east there's more wreckage. There are clearings to the southwest and the northwest.

>se
You can't go that way.

>nw
Landing Zone
You are on the beach. To the southeast lies the wreckage of what was once your magnificent airplane. To the southwest there's a clearing.

I beg your pardon?

I beg your pardon?

>quit
Are you sure you want to quit?

* * *

>se
Wreckage (West)
You are standing on the west side of the airplane, it saddens you to see the wreckage, it feels as though you lost a good friend. There is more of the airplane to the east; but not much on the beach to the northwest and southwest.

>nw
Northeast Beach
Thankfully you managed to land here, on the beach, when you ran out of fuel. If you look to the southeast, it is obvious that your trusty airplane wasn't as lucky. To the southwest the beach barely has any wreckage.

>sw
Northeast Beach (Inshore)
Hello

>se
East Beach Inshore
You are standing in a Beach on the beach, between the airplane wreckage to the northeast, and the forest to the west. The beach continues to the south and northwest.

* * *

>se
Wreckage (West)
You are standing on the west side of the airplane, it saddens you to see the wreckage, it feels as though you lost a good friend. There is more of the airplane to the east; but not much on the beach to the northwest and southwest.

>e
Wreckage (East)
You are standing on the east side of your airplane. It doesn't look any better from this angle; might as well go back to the west side.

>w
Wreckage (West)
You are standing on the west side of the airplane, it saddens you to see the wreckage, it feels as though you lost a good friend. There is more of the airplane to the east; but not much on the beach to the northwest and southwest.

>nw
Northeast Beach
Thankfully you managed to land here, on the beach, when you ran out of fuel. If you look to the southeast, it is obvious that your trusty airplane wasn't as lucky. To the southwest the beach barely has any wreckage.

>sw
Northeast Beach (inshore)
There's a marsh to the southwest. The remains of your aircraft are to the west. The beach continues to the northwest, northeast and southeast.

* * *

>s
You can't go that way.

>n
You can't go that way.

>w
You can't go that way.

>se
Wreckage (West)
You are standing on the west side of the airplane. It saddens you to see the wreckage; it feels as though you lost a good friend. There is more of the airplane to the east; but not much on the beach to the northwest and southwest.

>e
Wreckage (East)
You are standing on the east side of your airplane. It doesn't look any better from this angle; might as well go back to the west side.

>w
Wreckage (West)
You are standing on the west side of the airplane. It saddens you to see the wreckage; it feels as though you lost a good friend. There is more of the airplane to the east; but not much on the beach to the northwest and southwest.

>Awesome keyboard extender!
That's not a verb I recognise.

>WHAT HOW DARE YOU YOU INFEDEL
That's not a verb I recognise.

>IIIIIIIIIIIINFEDEEEEEEL
That's not a verb I recognise.

>Hel?
That's not a verb I recognise.

>That's a noun
That's not a verb I recognise.

>...
That's not a verb I recognise.

>>.<
That's not a verb I recognise.

>=P
That's not a verb I recognise.

>(.(
That's not a verb I recognise.

>\o/
That's not a verb I recognise.

>;_;
That's not a verb I recognise.

>\o>
That's not a verb I recognise.

>.o>
That's not a verb I recognise.

><o.
That's not a verb I recognise.

><o>
That's not a verb I recognise.

>\o>
That's not a verb I recognise.

><o/
That's not a verb I recognise.

>\o/
That's not a verb I recognise.

><o>
That's not a verb I recognise.

>nw
Northeast Beach
Thankfully you managed to land here, on the beach, when you ran out of fuel. If you look to the southeast, it is obvious that your trusty airplane wasn't as lucky. To the southwest the beach barely has any wreckage.

>nw
You can't go that way.

>sw
Northeast Beach (Inshore)
There's a marsh to the southwest. The remains of your aircraft are to the west. The beach continues to the northwest, northeast and southeast.

* * *

>ne
Northeast Beach
Thankfully you managed to land here, on the beach, when you ran out of fuel. If you look to the southeast, it is obvious that your trusty airplane wasn't as lucky. To the southwest the beach barely has any wreckage.

>sw
Northeast Beach (Inshore)
There's a marsh to the southwest. The remains of your aircraft are to the west. The beach continues to the northwest, northeast and southeast.

>se
East Beach (Inshore)
Airplane wreckage to the northeast, and the forest to the west. The beach continues to the south and northwest.

>w
Northeast Woods
There are birds singing in the trees around you while the sun sneaks a look at you through the copper leaves. The forest continues to the south and the northwest. To the west you can see a cave entrance and the beach is to the east.

>w
Cave Entrance
You are at the enterance of the cave, suprisingly, it's not too dark in there. The cave continues to the west, and the forest starts to the east.

* * *

>w
Cave Corridor
The mountain has erroded to the point where the cave has a crack in the ceiling here and there, which alows light to flow through and into the cave illuminating it just right. There are passages to the south, southwest and north.

>n
North Chamber
There's a single crack in the ceiling, the chamber is dry, there's even place for a fire. This looks like a good place to sleep.

* * *

>s
Cave Corridor
The mountain has erroded to the point where the cave has a crack in the ceiling here and there, which alows light to flow through and into the cave illuminating it just right. There are passages to the south, southwest and north.

>s
South Chamber
The floor slopes down into a large pool of rainwater which fills most of the chamber. The corridor is back to the north.

* * *

>n
Cave Corridor
The mountain has erroded to the point where the cave has a crack in the ceiling here and there, which alows light to flow through and into the cave illuminating it just right. There are passages to the south, southwest and north.

>sw
Southwest Chamber
This room is dark, there isn't really much you can see. Looks like a good place to store things. The corridor is back to the northeast.

>ne
Cave Corridor
The mountain has erroded to the point where the cave has a crack in the ceiling here and there, which alows light to flow through and into the cave illuminating it just right. There are passages to the south, southwest and north.

>e
Cave Entrance
You are at the enterance of the cave, suprisingly, it's not too dark in there. The cave continues to the west, and the forest starts to the east.

>e
Northeast Woods
There are birds singing in the trees around you while the sun sneaks a look at you through the copper leaves. The forest continues to the south and the northwest. To the west you can see a cave entrance and the beach is to the east.

>nw
Marsh
You are at a marsh, it has some reeds and a few bugs. To the northeast, there's a Beach near the crash site. The forest continues to the northwest and southeast.

>nw
North Woods
You can see the mountain in the south. There's a marsh to the southeast, and the edge of the forest is to the west.

>w
Northwest Woods
You are standing on the edge of the forest. The forest is thicker to the south and to the east. The beach is to the west.

>e
North Woods
You can see the mountain in the south. There's a marsh to the southeast, and the edge of the forest is to the west.

>w
Northwest Woods
You are standing on the edge of the forest. The forest is thicker to the south and to the east. The beach is to the west.

>s
West Woods
The trees here are few and far between. The leaves fall every now and then, like golden droplets. You can see a small stream run down the mountain in the east, its pure water glistening in the sun. To the west there is beach; the forest continues to the north and to the south.

>s
You can't go that way.

I beg your pardon?

>n
Northwest Woods
You are standing on the edge of the forest. The forest is thicker to the south and to the east. The beach is to the west.

>s
West Woods
The trees here are few and far between. The leaves fall every now and then, like golden droplets. You can see a small stream run down the mountain in the east, its pure water glistening in the sun. To the west there is beach; the forest continues to the north and to the south.

>w
West Beach
There isn't much beach here, mostly ocean. To the east is the forest, the beach continues in a northanly dirrection and to the south, where there are some large boulders.

>s
Upper Southwest Beach
This part of the island is sheltered from wind by the boulders around you. To the northwest, there's a cove, "ideal to launch a raft from!", you think. To the east is the forest. To the south is a rocky beach and to the north there is sandy beach.